Taxon	aggregate_oxygen_tol	aggregate_gram_stain	oral_related
Abiotrophia_defectiva	anaerobe	NA	NA
Actinomyces_cardiffensis	anaerobe	NA	NA
Actinomyces_dentalis	anaerobe	positive	TRUE
Actinomyces_georgiae	anaerobe/facultative anaerobe	positive	TRUE
Actinomyces_gerencseriae	microaerophile/anaerobe	positive	NA
Actinomyces_israelii	anaerobe	NA	NA
Actinomyces_johnsonii	anaerobe	NA	TRUE
Actinomyces_massiliensis	anaerobe/microaerophile	positive	NA
Actinomyces_meyeri	anaerobe	positive	NA
Actinomyces_naeslundii	anaerobe	NA	NA
Actinomyces_odontolyticus	anaerobe/microaerophile	NA	TRUE
Actinomyces_radicidentis	microaerophile	NA	NA
Actinomyces_ruminicola	obligate anaerobe	NA	NA
Actinomyces_timonensis	anaerobe/microaerophile	positive	NA
Actinomyces_urogenitalis	microaerophile/facultative anaerobe	positive	NA
Actinomyces_viscosus	anaerobe/microaerophile	NA	TRUE
Aggregatibacter_actinomycetemcomitans	microaerophile	NA	NA
Aggregatibacter_aphrophilus	microaerophile	NA	NA
Aggregatibacter_segnis	microaerophile	NA	TRUE
Alloprevotella_tannerae	anaerobe	NA	TRUE
Anaeroglobus_geminatus	anaerobe	NA	NA
Atopobium_parvulum	anaerobe	NA	NA
Atopobium_rimae	anaerobe	NA	TRUE
Bacteroides_heparinolyticus	anaerobe	NA	TRUE
Bacteroides_pyogenes	anaerobe	NA	NA
Bacteroides_zoogleoformans	anaerobe	NA	TRUE
Basfia_succiniciproducens	aerobe/facultative anaerobe/microaerophile	negative	NA
Brachymonas_chironomi	aerobe	negative	NA
Brachymonas_denitrificans	aerobe	NA	NA
Campylobacter_concisus	anaerobe/microaerophile	NA	TRUE
Campylobacter_curvus	anaerobe/microaerophile	NA	NA
Campylobacter_gracilis	anaerobe	NA	TRUE
Campylobacter_showae	anaerobe/microaerophile	negative	TRUE
Capnocytophaga_gingivalis	anaerobe/microaerophile	NA	TRUE
Capnocytophaga_granulosa	facultative anaerobe	NA	TRUE
Capnocytophaga_leadbetteri	microaerophile/anaerobe	negative	TRUE
Capnocytophaga_ochracea	anaerobe/microaerophile	NA	TRUE
Capnocytophaga_sputigena	anaerobe/microaerophile	NA	TRUE
Cardiobacterium_hominis	microaerophile	NA	NA
Cardiobacterium_valvarum	microaerophile	NA	NA
Centipeda_periodontii	anaerobe	NA	TRUE
Corynebacterium_durum	aerobe	positive	NA
Cryptobacterium_curtum	anaerobe/obligate anaerobe	positive	TRUE
Denitrobacterium_detoxificans	anaerobe	NA	NA
Desulfomicrobium_orale	anaerobe	NA	TRUE
Dialister_invisus	anaerobe/obligate anaerobe	NA	NA
Eggerthella_lenta	anaerobe	NA	NA
Eggerthia_catenaformis	anaerobe	NA	NA
Filifactor_alocis	anaerobe	NA	TRUE
Fusobacterium_necrophorum	anaerobe	NA	NA
Fusobacterium_nucleatum	anaerobe	NA	TRUE
Fusobacterium_periodonticum	anaerobe	NA	TRUE
Gemella_cuniculi	microaerophile/anaerobe	NA	NA
Gemella_morbillorum	anaerobe	NA	NA
Granulicatella_adiacens	anaerobe/microaerophile	NA	NA
Haemophilus_influenzae	microaerophile	NA	NA
Haemophilus_parainfluenzae	microaerophile	NA	NA
Jonquetella_anthropi	anaerobe	negative	NA
Kingella_oralis	microaerophile/aerobe	NA	TRUE
Kytococcus_sedentarius	aerobe	NA	NA
Lachnoanaerobaculum_saburreum	anaerobe	NA	TRUE
Lautropia_mirabilis	aerobe/microaerophile	NA	TRUE
Lawsonella_clevelandensis	anaerobe	positive	NA
Leptotrichia_buccalis	anaerobe/microaerophile	NA	TRUE
Leptotrichia_goodfellowii	anaerobe/microaerophile	negative	NA
Leptotrichia_hofstadii	anaerobe	negative	TRUE
Methanobrevibacter_millerae	anaerobe	NA	NA
Methanobrevibacter_olleyae	anaerobe	NA	NA
Methanobrevibacter_oralis	anaerobe	NA	TRUE
Methanobrevibacter_smithii	anaerobe	NA	NA
Mogibacterium_diversum	obligate anaerobe	NA	TRUE
Neisseria_bacilliformis	microaerophile	NA	NA
Neisseria_elongata	microaerophile	NA	NA
Neisseria_gonorrhoeae	microaerophile	NA	NA
Neisseria_lactamica	microaerophile	NA	NA
Neisseria_macacae	aerobe	NA	NA
Neisseria_meningitidis	microaerophile	NA	NA
Neisseria_mucosa	microaerophile	NA	NA
Neisseria_polysaccharea	microaerophile	NA	NA
Neisseria_shayeganii	microaerophile/facultative anaerobe/aerobe	negative	NA
Neisseria_sicca	microaerophile	NA	NA
Neisseria_zoodegmatis	facultative anaerobe	negative	NA
Olsenella_uli	obligate anaerobe/anaerobe	NA	TRUE
Olsenella_umbonata	obligate anaerobe/anaerobe	NA	NA
Oxalobacter_formigenes	anaerobe	NA	NA
Paraeggerthella_hongkongensis	anaerobe	NA	NA
Parvimonas_micra	anaerobe	NA	NA
Pasteurella_testudinis	aerobe	NA	NA
Peptoanaerobacter_stomatis	anaerobe	NA	TRUE
Phocaeicola_abscessus	anaerobe	negative	NA
Porphyromonas_catoniae	anaerobe	NA	TRUE
Porphyromonas_gingivalis	anaerobe	NA	TRUE
Porphyromonas_gulae	anaerobe	NA	TRUE
Prevotella_baroniae	anaerobe	negative	TRUE
Prevotella_intermedia	anaerobe	NA	NA
Prevotella_loescheii	anaerobe	NA	TRUE
Prevotella_maculosa	anaerobe	negative	TRUE
Prevotella_micans	anaerobe	negative	TRUE
Prevotella_saccharolytica	anaerobe	negative	TRUE
Propionibacterium_acidifaciens	anaerobe	positive	TRUE
Propionibacterium_australiense	anaerobe	NA	NA
Propionibacterium_freudenreichii	anaerobe/microaerophile	NA	NA
Pseudopropionibacterium_propionicum	anaerobe/microaerophile	NA	NA
Pseudoramibacter_alactolyticus	anaerobe	NA	NA
Rothia_aeria	aerobe/microaerophile	positive	NA
Rothia_dentocariosa	anaerobe/microaerophile	NA	TRUE
Rothia_mucilaginosa	microaerophile	NA	NA
Sanguibacter_keddieii	aerobe	NA	NA
Selenomonas_artemidis	anaerobe	NA	TRUE
Selenomonas_infelix	anaerobe	NA	TRUE
Selenomonas_noxia	anaerobe	NA	TRUE
Selenomonas_sputigena	anaerobe	NA	TRUE
Shuttleworthia_satelles	anaerobe	NA	TRUE
Slackia_exigua	anaerobe	NA	NA
Slackia_heliotrinireducens	anaerobe	NA	NA
Solobacterium_moorei	anaerobe	NA	NA
Staphylococcus_xylosus	aerobe	NA	NA
Streptococcus_anginosus	microaerophile/anaerobe	NA	NA
Streptococcus_constellatus	microaerophile/anaerobe	NA	NA
Streptococcus_cristatus	microaerophile	NA	TRUE
Streptococcus_devriesei	microaerophile	NA	TRUE
Streptococcus_equi	microaerophile	NA	NA
Streptococcus_ferus	anaerobe	NA	TRUE
Streptococcus_gallolyticus	microaerophile/aerobe	NA	NA
Streptococcus_gordonii	microaerophile	NA	NA
Streptococcus_intermedius	microaerophile/anaerobe	NA	NA
Streptococcus_macedonicus	microaerophile	NA	NA
Streptococcus_merionis	microaerophile/facultative anaerobe	positive	NA
Streptococcus_mitis	microaerophile	NA	TRUE
Streptococcus_mutans	microaerophile	NA	TRUE
Streptococcus_oralis	microaerophile/facultative anaerobe	positive	TRUE
Streptococcus_parasanguinis	microaerophile	NA	NA
Streptococcus_pneumoniae	microaerophile	NA	NA
Streptococcus_pseudopneumoniae	microaerophile	NA	NA
Streptococcus_pyogenes	microaerophile	NA	NA
Streptococcus_salivarius	microaerophile/aerobe	NA	NA
Streptococcus_sanguinis	microaerophile	NA	NA
Streptococcus_sobrinus	microaerophile	NA	TRUE
Streptococcus_suis	anaerobe/microaerophile/aerobe	NA	NA
Tannerella_forsythia	anaerobe	NA	TRUE
Tissierella_praeacuta	anaerobe	NA	NA
Treponema_denticola	anaerobe	NA	TRUE
Treponema_maltophilum	anaerobe	NA	TRUE
Treponema_putidum	anaerobe	"NA"	TRUE
Veillonella_dispar	anaerobe	NA	TRUE
Veillonella_parvula	anaerobe	NA	TRUE
Veillonella_rodentium	anaerobe	NA	TRUE
Veillonella_tobetsuensis	anaerobe	negative	NA
